You have once again lost in a drone war against your friend. You are ready to give up and go home, disappointed in yet another failed attempt at luring and attacking him from behind. Just as you decide to give up your wings for good, you friend offers you a hand up...
Drone Wars
An Interactive Fiction by Jethro
Release 1 / Serial number 180115 / Inform 7 build 6M62 (I6/v6.33 lib 6/12N) SD

Forest
You stand in a clearing in the deep jungle. Obscured by centuries of overgrowth and dim sunlight is a ruined temple of some sort. Whatever details there may have been on the stone blocks have long since been worn away. There is a single, solitary entryway leading downward.

>showme
Forest - room
    yourself - person

* * *

>l
Forest
You stand in a clearing in the deep jungle. Obscured by centuries of overgrowth and dim sunlight is a ruined temple of some sort. Whatever details there may have been on the stone blocks have long since been worn away. There is a single, solitary entryway leading downward.

>s
Darkness

>w
You can't go that way.

* * *

>e
You can't go that way.

>n
Forest
You stand in a clearing in the deep jungle. Obscured by centuries of overgrowth and dim sunlight is a ruined temple of some sort. Whatever details there may have been on the stone blocks have long since been worn away. There is a single, solitary entryway leading downward.

>s
Darkness

I beg your pardon?

* * *

>l
Forest
You stand in a clearing in the deep jungle. Obscured by centuries of overgrowth and dim sunlight is a ruined temple of some sort. Whatever details there may have been on the stone blocks have long since been worn away. There is a single, solitary entryway leading downward.

A low flying drone pokes out behind some green grass.

>showme
Forest - room
    yourself - person
    drone

>inside
upper campus

>l
upper campus

* * *

>l
Forest
You stand in a clearing in the deep jungle. Obscured by centuries of overgrowth and dim sunlight is a ruined temple of some sort. Whatever details there may have been on the stone blocks have long since been worn away. There is a single, solitary entryway leading downward.

A low flying drone pokes out behind some green grass.

>n
Upper Campus

>s
Forest
You stand in a clearing in the deep jungle. Obscured by centuries of overgrowth and dim sunlight is a ruined temple of some sort. Whatever details there may have been on the stone blocks have long since been worn away. There is a single, solitary entryway leading downward.

A low flying drone pokes out behind some green grass.

>s
You can't go that way.

>w
Forest Lake

>e
Forest
You stand in a clearing in the deep jungle. Obscured by centuries of overgrowth and dim sunlight is a ruined temple of some sort. Whatever details there may have been on the stone blocks have long since been worn away. There is a single, solitary entryway leading downward.

A low flying drone pokes out behind some green grass.

>e
The Forest Inn

* * *

>s
You can't go that way.

>n
You can't go that way.

>w
You can't go that way.

* * *

>w
Forest Lake

>e
Forest
You stand in a clearing in the deep jungle. Obscured by centuries of overgrowth and dim sunlight is a ruined temple of some sort. Whatever details there may have been on the stone blocks have long since been worn away. There is a single, solitary entryway leading downward.

>e
The Forest Inn
A low flying drone pokes out behind some green grass.

>w
darkness

* * *

>inside
The Forest Inn

>outside
Forest
You stand in a clearing in the deep jungle. Obscured by centuries of overgrowth and dim sunlight is a ruined temple of some sort. Whatever details there may have been on the stone blocks have long since been worn away. There is a single, solitary entryway leading downward.

A low flying drone pokes out behind some green grass.

>w
Forest Lake

* * *

>e
The Forest Inn

>outside
Forest
You stand in a clearing in the deep jungle. Obscured by centuries of overgrowth and dim sunlight is a ruined temple of some sort. Whatever details there may have been on the stone blocks have long since been worn away. There is a single, solitary entryway leading downward.

A low flying drone pokes out behind some green grass.

* * *

>e
The Forest Inn
A low flying drone pokes out behind some green grass.

>e
Forest
You stand in a clearing in the deep jungle. Obscured by centuries of overgrowth and dim sunlight is a ruined temple of some sort. Whatever details there may have been on the stone blocks have long since been worn away. There is a single, solitary entryway leading downward.