You have once again lost in a drone war against your friend. You are ready to give up and go home, disappointed in yet another failed attempt at luring and attacking him from behind. Just as you decide to give up your wings for good, you friend offers you a hand up...
Drone Wars
An Interactive Fiction by Jethro
Release 1 / Serial number 180115 / Inform 7 build 6M62 (I6/v6.33 lib 6/12N) SD

Forest
You stand in a clearing in the deep jungle. Obscured by centuries of overgrowth and dim sunlight is a ruined temple of some sort. Whatever details there may have been on the stone blocks have long since been worn away. There is a single, solitary entryway leading downward.

A low flying drone pokes out behind some green grass.

 Who knows what would happen if this mysterious button were pressed. 

Andrew's drone sits superior on a large boulder infront of the leaves. You look at the drone in envy and at yours with scorn.

On the boulder is Invisible shield (closed) (in which is Andrew's drone).

You can also see the cloud, Forest Barrier, Adam, a dagger, a dildo, a rope, a forest fiend and Golden amulet here.

>l
Forest
You stand in a clearing in the deep jungle. Obscured by centuries of overgrowth and dim sunlight is a ruined temple of some sort. Whatever details there may have been on the stone blocks have long since been worn away. There is a single, solitary entryway leading downward.

A low flying drone pokes out behind some green grass.

 Who knows what would happen if this mysterious button were pressed. 

Andrew's drone sits superior on a large boulder infront of the leaves. You look at the drone in envy and at yours with scorn.

On the boulder is Invisible shield (closed) (in which is Andrew's drone).

You can also see the cloud and Forest Barrier here.

>x entryway
You can't see any such thing.

>say sigh
(to yourself)
There is no reply.

>jump
You jump on the spot.

>walk
You'll have to say which compass direction to go in.

>w s
I only understood you as far as wanting to (go) w.

>s
You can't go that way.

>w
You can't go that way.

>e
You can't go that way.

>n
You can't go that way.

>cry
That's not a verb I recognise.

>die
That's not a verb I recognise.

>sigh
That's not a verb I recognise.

>lol
That's not a verb I recognise.

>sit
What do you want to sit on?

>floor
You can't see any such thing.

>sit
What do you want to sit on?

>l
Forest
You stand in a clearing in the deep jungle. Obscured by centuries of overgrowth and dim sunlight is a ruined temple of some sort. Whatever details there may have been on the stone blocks have long since been worn away. There is a single, solitary entryway leading downward.

>shout
I didn't understand that sentence.

>shout
I didn't understand that sentence.

>ask
What do you want to ask yourself for?

>strength
You can't see any such thing.

>ask strength
You can't see any such thing.

* * *

>take button
Taken.

>i
You are carrying:
  a self destruct button

>switch on button
You press the button and instantly vapourize into thin air.

* * *

>open mushroom
That's already open.

>close mushroom
You close the mushroom.

>eat mushroom
That's plainly inedible.

* * *

>eat mushroom
(first taking the mushroom)
You deftly snap the mushroom's stalk, and pluck the hapless fungus from its natural habitat.

You pop the scrumptulescent mushroom treat into your mouth. It tastes like fungal-flavored candy. The gastronomical delight turns out to be a toadstool, and you succumb to its choking, asphyxiating aftertaste.

    *** You have died ***

Would you like to RESTART, RESTORE a saved game, QUIT or UNDO the last command?

>undo
Forest
[Previous turn undone.]

>open mushroom
That's already open.

>eat it
(first taking the mushroom)
You eat the mushroom. Not bad.

* * *

>take mushroom
You deftly snap the mushroom's stalk, and pluck the hapless fungus from its natural habitat.

>drop mushroom
You deftly snap the mushroom's stalk, and pluck the hapless fungus from its natural habitat.

>take mushroom
You deftly snap the mushroom's stalk, and pluck the hapless fungus from its natural habitat.

* * *

>take drone
(the destroyer)
 You deftly grab the palm sized drone, clean the blades, and toss it into your pocket.

>toss drone
You toss the drone upwards and hear its motor whirl as it begins to levitate at shoulder height.

* * *

>take drone
(the destroyer)
 You deftly grab the palm sized drone, clean the blades, and toss it into your pocket.

>i
You are carrying:
  a drone

* * *

>take drone
(the destroyer)
 You deftly grab the palm sized drone, clean the blades, and toss it into your pocket.

>take dagger
Taken.

>take rope
Taken.

>i
You are carrying:
  a rope
  a dagger
  a destroyer

* * *

>take Andrews drone
You can't see any such thing.

>take Andrew's drone
You can't see any such thing.

>l
Forest
You stand in a clearing in the deep jungle. Obscured by centuries of overgrowth and dim sunlight is a ruined temple of some sort. Whatever details there may have been on the stone blocks have long since been worn away. There is a single, solitary entryway leading downward.

>showme
Forest - room
    yourself - person

>l
Forest
You stand in a clearing in the deep jungle. Obscured by centuries of overgrowth and dim sunlight is a ruined temple of some sort. Whatever details there may have been on the stone blocks have long since been worn away. There is a single, solitary entryway leading downward.

* * *

>Take andrew
Taken.

>i
You are carrying:
  Andrew

>drop andrew
Dropped.

>l
Forest
You stand in a clearing in the deep jungle. Obscured by centuries of overgrowth and dim sunlight is a ruined temple of some sort. Whatever details there may have been on the stone blocks have long since been worn away. There is a single, solitary entryway leading downward.

A low flying drone pokes out behind some green grass.

You can also see Andrew here.

>x andrew
You see nothing special about Andrew.

* * *

>take boulder
That's fixed in place.

>take andrews drone
You can't see any such thing.

>take andrew's drone
Taken.

* * *

>take boulder
That's fixed in place.

>l
Forest
You stand in a clearing in the deep jungle. Obscured by centuries of overgrowth and dim sunlight is a ruined temple of some sort. Whatever details there may have been on the stone blocks have long since been worn away. There is a single, solitary entryway leading downward.

A low flying drone pokes out behind some green grass.

Andrew's drone sits superior on a large boulder infront of the leaves.

On the boulder is Invisible shield (closed) (in which is Andrew's drone).

You can also see the cloud here.

>i
You are carrying nothing.

* * *

>take Andrew's drone
Invisible shield isn't open.

>take invisible shield
That's fixed in place.

* * *

>take drown
You can't see any such thing.

>take drown
You can't see any such thing.

>take drone
(the destroyer.)
 You deftly grab the palm sized drone, clean the blades, and toss it into your pocket.

>i
You are carrying:
  a destroyer.

* * *

>open Forest Barrier
It seems to be locked.

* * *

>open Forest barrier
It seems to be locked.

>take drone
(the destroyer)
 You deftly grab the palm sized drone, clean the blades, and toss it into your pocket.

>open forest barrier
It seems to be locked.

>unlock forest barrier with drone
(the destroyer)
You unlock Forest Barrier.

* * *

>switch on button
You press the button and instantly vapourize into thin air.

    *** The End ***

Would you like to RESTART, RESTORE a saved game, QUIT or UNDO the last command?

* * *

>enter hoverboard
You can't see any such thing.

>l
Forest
You stand in a clearing in the deep jungle. Obscured by centuries of overgrowth and dim sunlight is a ruined temple of some sort. Whatever details there may have been on the stone blocks have long since been worn away. There is a single, solitary entryway leading downward.

A low flying drone pokes out behind some green grass.

 Who knows what would happen if this mysterious button were pressed. 

Andrew's drone sits superior on a large boulder infront of the leaves. You look at the drone in envy and at yours with scorn.

On the boulder is Invisible shield (closed) (in which is Andrew's drone).

You can also see the cloud and Forest Barrier here.

>enter hoverboard
You can't see any such thing.

* * *

>inside
The Forest Inn
You can see hoverboard (empty) here.

>enter hoverboard
You get into hoverboard.

>s
You can't go that way.

>w
Forest (in hoverboard)
You stand in a clearing in the deep jungle. Obscured by centuries of overgrowth and dim sunlight is a ruined temple of some sort. Whatever details there may have been on the stone blocks have long since been worn away. There is a single, solitary entryway leading downward.

A low flying drone pokes out behind some green grass.

 Who knows what would happen if this mysterious button were pressed. 

Andrew's drone sits superior on a large boulder infront of the leaves. You look at the drone in envy and at yours with scorn.

On the boulder is Invisible shield (closed) (in which is Andrew's drone).

You can also see the cloud and Forest Barrier here.

>get out
You get out of hoverboard.

Forest
You stand in a clearing in the deep jungle. Obscured by centuries of overgrowth and dim sunlight is a ruined temple of some sort. Whatever details there may have been on the stone blocks have long since been worn away. There is a single, solitary entryway leading downward.

A low flying drone pokes out behind some green grass.

 Who knows what would happen if this mysterious button were pressed. 

Andrew's drone sits superior on a large boulder infront of the leaves. You look at the drone in envy and at yours with scorn.

On the boulder is Invisible shield (closed) (in which is Andrew's drone).

You can also see hoverboard (empty), the cloud and Forest Barrier here.

>get in
You get into hoverboard.

>get out
You get out of hoverboard.

Forest
You stand in a clearing in the deep jungle. Obscured by centuries of overgrowth and dim sunlight is a ruined temple of some sort. Whatever details there may have been on the stone blocks have long since been worn away. There is a single, solitary entryway leading downward.

A low flying drone pokes out behind some green grass.

 Who knows what would happen if this mysterious button were pressed. 

Andrew's drone sits superior on a large boulder infront of the leaves. You look at the drone in envy and at yours with scorn.

On the boulder is Invisible shield (closed) (in which is Andrew's drone).

You can also see hoverboard (empty), the cloud and Forest Barrier here.

>get on
You get into hoverboard.

* * *

>get in hoverboard
You can't see any such thing.

>w
Forest Lake

>e
Forest
You stand in a clearing in the deep jungle. Obscured by centuries of overgrowth and dim sunlight is a ruined temple of some sort. Whatever details there may have been on the stone blocks have long since been worn away. There is a single, solitary entryway leading downward.

A low flying drone pokes out behind some green grass.

 Who knows what would happen if this mysterious button were pressed. 

Andrew's drone sits superior on a large boulder infront of the leaves. You look at the drone in envy and at yours with scorn.

On the boulder is Invisible shield (closed) (in which is Andrew's drone).

You can also see the cloud and Forest Barrier here.

>e
The Forest Inn
You can see hoverboard (empty) here.

>get in
The hoverboard sinks ever-so-slightly under  your weight and you feel the vibration of the engine under your feet.

* * *

>e
The Forest Inn
You can see hoverboard (empty) and Jezebel here.

* * *

>hit adam
Violence isn't the answer to this one.

>talk
That's not a verb I recognise.

>talk to adam
That's not a verb I recognise.

>jump on adam
I only understood you as far as wanting to jump.

>hit
What do you want to hit?

>ground
You can't see any such thing.

>hit boulder
Violence isn't the answer to this one.

>hit bo
You can't see any such thing.

>take drown
You can't see any such thing.

>take drone
(the destroyer)
 You deftly grab the palm sized drone, clean the blades, and toss it into your pocket.

>throw drone
(the destroyer)
You discard the abused drone to the ground like a used facial tissue.

>kick drone
That's not a verb I recognise.

>ask
What do you want to ask Adam for?

>life
You can't see any such thing.

>ask adam for life
You can't see any such thing.

>i
You are carrying nothing.

>l
Forest
You stand in a clearing in the deep jungle. Obscured by centuries of overgrowth and dim sunlight is a ruined temple of some sort. Whatever details there may have been on the stone blocks have long since been worn away. There is a single, solitary entryway leading downward.

 Who knows what would happen if this mysterious button were pressed. 

Andrew's drone sits superior on a large boulder infront of the leaves. You look at the drone in envy and at yours with scorn.

On the boulder is Invisible shield (closed) (in which is Andrew's drone).

You can also see a destroyer, the cloud, Forest Barrier and Adam here.

>x drone
(the destroyer)
Upon further examination, you notice that it's struggling to stay in the air. You should examine it further.

>x drone
(the destroyer)
Now that you look at it again, you can see clearly that it has a thick transparent layer of slime on its blades; a nasty looking slime, at that.

>clean drone
(the destroyer)
You rub the destroyer.

>x drone
(the destroyer)
Now that you look at it again, you can see clearly that it has a thick transparent layer of slime on its blades; a nasty looking slime, at that.

>clean adam
Adam might not like that.

>shout
I didn't understand that sentence.

>take
What do you want to take?

>shield
That's fixed in place.

>take gate
You can't see any such thing.

>take barrier
That's fixed in place.

>take drone
(the destroyer)

>i
You are carrying:
  a destroyer

>l
Forest
You stand in a clearing in the deep jungle. Obscured by centuries of overgrowth and dim sunlight is a ruined temple of some sort. Whatever details there may have been on the stone blocks have long since been worn away. There is a single, solitary entryway leading downward.

 Who knows what would happen if this mysterious button were pressed. 

Andrew's drone sits superior on a large boulder infront of the leaves. You look at the drone in envy and at yours with scorn.

On the boulder is Invisible shield (closed) (in which is Andrew's drone).

You can also see the cloud, Forest Barrier and Adam here.

>take cloud
That's fixed in place.

>take boulder
That's fixed in place.

>open shield
It seems to be locked.

>take adam's drone
You can't see any such thing.

>e
The Forest Inn
You can see hoverboard (empty) and Jezebel here.

>take Jezebel
I don't suppose Jezebel would care for that.

>take hoverboard
That's fixed in place.

* * *

>ask adam for gift
Adam has better things to do.

>ask adam for gif
You can't see any such thing.

>take adam's gift
You can't see any such thing.

>take gift
That seems to belong to Adam.

* * *

>take dagger, dildo, rope
dagger: Taken.
dildo: Taken.
rope: Taken.

>take drone
(the destroyer)
You're carrying too many things already.

>drop all
rope: Dropped.
dildo: Dropped.
dagger: Dropped.

>take all
dagger: Taken.
dildo: Taken.
rope: Taken.
destroyer: You're carrying too many things already.
self destruct button: You're carrying too many things already.
gift: That seems to belong to Adam.

>drop all
rope: Dropped.
dildo: Dropped.
dagger: Dropped.

>showme
Forest - room
    dagger
    dildo
    rope
    yourself - person
    destroyer
    boulder - supporter
        Invisible shield - transparent locked container
            Andrew's drone
        self destruct button - device
    cloud - supporter
    Forest Barrier - locked door
    Adam - man
        gift

>take button
Taken.

* * *

>i
You are carrying:
  a self destruct button

>push button
Nothing obvious happens.

>i
You are carrying:
  a self destruct button

>switch off button
That's already off.

>switch on button
You press the button and instantly vapourize into thin air.

    *** The End ***

Would you like to RESTART, RESTORE a saved game, QUIT or UNDO the last command?

>quit
[ The game has finished ]

* * *

>x forest fiend
You see nothing special about the forest fiend.

>take all
destroyer:  You deftly grab the palm sized drone, clean the blades, and toss it into your pocket.
dagger: Taken.
dildo: Taken.
rope: You're carrying too many things already.
self destruct button: You're carrying too many things already.
gift: That seems to belong to Adam.
HIV: That seems to belong to the forest fiend.

>stab forest fiend
That's not a verb I recognise.

* * *

>stab
That's not a verb I recognise.

>stab forest
That's not a verb I recognise.

>stab forest fiend
That's not a verb I recognise.

>Stab forest fiend
That's not a verb I recognise.

>stab
That's not a verb I recognise.

* * *

>stab forest fiend
You stab the forest fiend. The blood pours down the dagger and onto your hand.

* * *

>wear golden
(first taking Golden amulet)
You put on Golden amulet.

>i
You are carrying:
  Golden amulet (being worn)

* * *

>i
You are carrying nothing.

>take all
destroyer:  You deftly grab the palm sized drone, clean the blades, and toss it into your pocket.
dagger: Taken.
dildo: Taken.
rope: You're carrying too many things already.
Golden amulet: You're carrying too many things already.
self destruct button: You're carrying too many things already.
gift: That seems to belong to Adam.
HIV: That seems to belong to the forest fiend.

>drop all
dildo: Dropped.
dagger: Dropped.
destroyer: You discard the abused drone to the ground like a used facial tissue.

>drop magic backpack
You can't see any such thing.